04 04 04 04 04 04 04 04 04 04 04 04 04 04 04 04 04 04 04 04 04 04 04 04 04 04 04 04 04 04 04 04 04 04 04 04 04 04 04 04 04 04 04 04 04 04 04 04 04 04 04 04 04 04 04 04 04 04 04 04 04 04 04 04 04 04
04 04 04 04 04 04 04 04 04 04 04 04 04 04 04 04 04 04 04 04 04 04 04 04 04 04 04 04 04 04 04 04 04 04 04 04 04 04 04 04 04 04 04 04 04 04 04 04 04 04 04 04 04 04 04 04 04 04 04 04 04 04 04 04 04 04
04 00 00 00 00 00 08 00 00 00 00 00 00 00 00 00 08 00 00 00 00 00 00 00 00 00 00 00 00 00 00 00 00 00 00 00 00 00 00 00 00 00 00 00 00 00 00 00 00 00 00 00 00 00 00 00 00 00 00 00 00 00 00 00 00 04
04 00 00 00 00 00 00 00 00 00 00 00 00 00 00 00 00 00 00 00 00 00 00 00 00 00 00 06 00 00 00 00 00 00 00 00 00 00 00 00 00 00 00 00 00 06 00 00 00 00 00 00 00 00 06 00 00 00 00 00 00 00 00 00 00 04
04 00 06 00 00 00 00 20 21 22 23 24 25 26 27 28 00 00 00 00 00 11 10 11 10 11 00 00 00 11 10 11 10 11 00 00 00 11 10 11 10 11 00 00 00 00 00 00 00 00 00 00 00 00 00 00 00 00 00 00 00 00 00 06 00 04
04 00 00 00 00 00 00 29 30 31 32 33 34 35 36 37 00 00 00 00 00 10 10 10 10 10 00 00 00 10 10 10 10 10 00 00 00 10 10 10 10 10 00 00 00 00 00 03 03 03 03 03 03 03 03 03 03 03 03 03 03 03 03 00 00 04
04 00 00 00 00 00 06 38 39 40 41 42 43 44 45 46 00 00 06 00 00 11 10 02 10 11 00 00 00 11 10 02 10 11 00 00 00 11 10 02 10 11 00 00 00 00 00 03 07 07 07 07 07 07 07 07 07 07 07 07 07 07 03 00 00 04
04 00 00 08 00 00 00 47 48 49 50 51 52 53 54 55 00 00 00 00 00 10 10 10 10 10 00 00 00 10 10 10 10 10 00 06 00 10 10 10 10 10 00 00 00 00 00 03 07 02 07 02 07 02 07 02 07 02 07 02 07 07 03 00 00 04
04 00 00 00 00 00 00 56 57 58 59 60 61 62 63 64 06 00 00 00 00 11 10 10 10 11 00 00 00 11 10 10 10 11 00 00 00 11 10 10 10 11 00 00 00 00 00 03 07 07 07 07 07 07 07 07 07 07 07 07 02 07 03 00 06 04
04 00 00 00 00 00 00 00 00 00 00 01 00 00 00 00 00 00 00 00 06 00 00 01 00 00 00 00 00 00 00 01 00 00 00 00 00 00 00 01 00 00 00 06 00 00 00 03 07 07 07 07 07 07 07 07 07 07 07 07 07 07 03 00 00 04
04 00 05 05 05 00 00 00 00 00 00 01 00 00 00 00 00 00 00 00 00 00 00 01 00 00 00 00 00 00 00 01 00 00 00 00 00 00 00 01 00 00 00 00 00 00 00 07 07 07 07 07 07 07 07 07 07 07 07 07 02 07 03 00 00 04
04 00 05 05 05 09 09 09 09 09 09 10 09 09 09 09 09 09 09 09 09 09 09 10 09 09 09 09 09 09 09 10 09 09 09 09 09 09 09 10 09 09 09 09 09 09 09 07 07 07 07 07 07 07 07 07 07 07 07 07 07 07 03 00 00 04
04 00 05 05 05 00 00 00 00 00 00 01 00 08 00 00 00 00 00 00 00 00 00 01 00 00 00 00 00 00 00 01 00 00 00 00 00 00 00 01 00 00 00 00 00 00 00 07 07 07 07 07 07 07 07 07 07 07 07 07 02 07 03 08 00 04
04 00 00 00 00 00 00 00 00 00 00 01 00 00 00 00 00 00 00 00 00 00 00 01 00 00 00 00 00 08 00 01 00 00 00 00 00 00 00 01 00 00 00 00 00 00 00 03 07 07 07 07 07 07 07 07 07 07 07 07 07 07 03 00 00 04
04 00 00 00 00 00 00 00 00 00 65 66 67 00 00 00 00 08 00 00 00 11 10 10 10 11 06 00 00 11 10 10 10 11 00 00 06 11 10 10 10 11 00 00 00 00 00 03 07 07 07 07 07 07 07 07 07 07 07 07 02 07 03 00 00 04
04 00 00 00 00 00 00 00 00 00 68 69 70 00 00 00 00 00 00 00 00 10 10 10 10 10 00 00 00 10 10 10 10 10 00 00 00 10 10 10 10 10 00 00 00 00 00 03 07 02 07 02 07 02 07 02 07 02 07 02 07 07 03 00 00 04
04 00 00 00 06 00 00 00 00 00 71 72 73 00 00 00 00 00 00 00 00 11 10 02 10 11 00 00 00 11 10 02 10 11 00 00 00 11 10 02 10 11 00 06 00 00 00 03 07 07 07 07 07 07 07 07 07 07 07 07 07 07 03 00 00 04
04 00 00 00 00 00 00 00 00 00 00 00 00 00 00 00 00 00 00 00 00 10 10 10 10 10 00 00 00 10 10 10 10 10 00 08 00 10 10 10 10 10 00 00 00 00 00 03 03 03 03 03 03 03 03 03 03 03 03 03 03 03 03 00 00 04
04 00 00 00 00 00 00 00 00 00 00 00 00 00 00 00 00 00 00 00 00 11 10 11 10 11 00 00 00 11 10 11 10 11 00 00 00 11 10 11 10 11 00 00 00 00 00 00 00 00 00 00 00 00 00 00 08 00 00 00 00 00 00 00 00 04
04 00 08 00 00 00 00 00 00 06 00 00 00 00 00 08 00 00 00 00 00 00 00 00 00 00 00 00 06 00 00 00 00 00 00 00 00 00 00 00 00 00 00 00 00 00 00 00 00 00 00 06 00 00 00 00 00 00 00 00 00 00 00 00 00 04
04 00 00 00 00 00 00 00 00 00 00 00 00 00 00 00 00 00 00 00 00 00 00 00 00 00 00 00 00 00 00 00 00 00 00 00 00 00 00 00 00 00 00 00 00 00 00 00 00 00 00 00 00 00 00 00 00 00 00 00 06 00 00 00 00 04
04 04 04 04 04 04 04 04 04 04 04 04 04 04 04 04 04 04 04 04 04 04 04 04 04 04 04 04 04 04 04 04 04 04 04 04 04 04 04 04 04 04 04 04 04 04 04 04 04 04 04 04 04 04 04 04 04 04 04 04 04 04 04 04 04 04
04 04 04 04 04 04 04 04 04 04 04 04 04 04 04 04 04 04 04 04 04 04 04 04 04 04 04 04 04 04 04 04 04 04 04 04 04 04 04 04 04 04 04 04 04 04 04 04 04 04 04 04 04 04 04 04 04 04 04 04 04 04 04 04 04 04
