04 04 04 04 04 04 04 04 04 04 04 04 04 04 04 04 04 04 04 04 04 04 04 04 04 04 04 04 04 04 04 04 04 04 04
04 00 00 00 00 00 00 00 00 00 00 00 00 00 00 00 00 00 00 00 00 00 00 00 00 00 00 00 00 00 00 00 00 00 04
04 00 00 00 00 00 00 00 00 00 00 00 00 00 00 00 00 00 00 00 00 00 00 00 00 00 00 00 00 00 00 00 00 00 04
04 00 00 00 00 00 00 20 21 22 23 24 25 26 27 28 00 00 00 00 00 00 00 00 00 00 00 00 00 00 00 00 00 00 04
04 00 00 00 00 00 00 29 30 31 32 33 34 35 36 37 00 00 18 11 15 00 00 18 11 15 00 00 18 11 15 00 00 00 04
04 00 00 00 00 00 00 38 39 40 41 42 43 44 45 46 00 00 13 02 14 00 00 13 02 14 00 00 13 02 14 00 00 00 04
04 00 00 00 00 00 00 47 48 49 50 51 52 53 54 55 00 00 17 12 16 00 00 17 12 16 00 00 17 12 16 00 00 00 04
04 00 00 00 00 00 00 56 57 58 59 60 61 62 63 64 00 00 00 01 00 00 00 00 01 00 00 00 00 01 00 00 00 00 04
04 00 00 05 05 05 00 00 00 00 00 01 00 00 00 00 00 00 00 01 00 00 00 00 01 00 00 00 00 01 00 00 00 00 04
04 00 00 05 05 05 09 09 09 09 09 10 09 09 09 09 09 09 09 10 09 09 09 09 10 09 09 09 09 10 00 00 00 00 04
04 00 00 05 05 05 00 00 00 00 00 01 00 00 00 00 00 00 00 01 00 00 00 00 01 00 00 00 00 01 00 00 00 00 04
04 00 00 00 00 00 00 03 03 03 03 07 03 03 03 03 00 00 00 01 00 00 00 00 01 00 00 00 00 01 00 00 00 00 04
04 00 00 00 00 00 00 03 07 07 07 07 07 07 07 03 00 00 18 11 15 00 00 18 11 15 00 00 18 11 15 00 00 00 04
04 00 00 00 00 00 00 03 07 07 07 07 07 07 07 03 00 00 13 02 14 00 00 13 02 14 00 00 13 02 14 00 00 00 04
04 00 00 00 00 00 00 03 06 06 06 07 06 06 06 03 00 00 17 12 16 00 00 17 12 16 00 00 17 12 16 00 00 00 04
04 00 00 00 00 00 00 03 03 03 03 03 03 03 03 03 00 00 00 00 00 00 00 00 00 00 00 00 00 00 00 00 00 00 04
04 00 00 00 00 00 00 00 00 00 00 00 00 00 00 00 00 00 00 00 00 00 00 00 00 00 00 00 00 00 00 00 00 00 04
04 04 04 04 04 04 04 04 04 04 04 04 04 04 04 04 04 04 04 04 04 04 04 04 04 04 04 04 04 04 04 04 04 04 04